00000000000000000000000000000000000000000000000000000000000000000000000000000000
00------------------000000000000000000000000000000000000000000000000000000000000
00|................|0000000000---------------------00000000000000000000000000000
00|................|0000000000|...................+############################0
00|................+##########+...................|000000000000000000#0000000000
00|................|0000000000----------+----------000000000000000000#0000000000
00|................|00000000000000000000#0000000000000000000000------+----000000
00---------+--------00000000000000000000##000000000000000000000|.........|000000
00000000####00000000000000000000000000000####000000000000000000|.........|000000
00000####0000000000000000000000000000000000##000000000000000000----+------000000
0000000######0000000000000000000000000000000##000000000000000000000#000000000000
00000-------+-------000000000000000----------+---0000000000000-----+-------00000
00000|.............|000000000000000|............|0000000000000|...........|00000
00000|.............+########0000000|............|0000#########+...........|00000
00000-------+-------0000000########+............|0000#00000000-------------00000
0000000000###0000000000000000000000----------+---0000#00000000000000000000000000
000000000000##00000000000000000000000000000###0000000#00-----------0000000000000
0000000------+--00000000000000000000000000##000000000#00|.........|0000000000000
0000000|.......+######0000000000000-------+------0000###+.........|0000000000000
0000000|.......|00000#########00000|............|0000000-----+-----0000000000000
0000000---------0000000000000######+............+#############000000000000000000
00000000000000000000000000000000000--------------0000000000000000000000000000000
00000000000000000000000000000000000000000000000000000000000000000000000000000000
1,2,7,19:2,30,5,50:6,63,9,73:11,5,14,19:11,35,15,48:11,62,14,74:17,7,20,15:18,35,21,48:16,56,19,66E